28 57
MMMMMMMMMMMMMMMMMMMMMMMMMMMMMMMMMMMMMMMMMMMMMMMMMMMMMMMMM
E MMMMMMMMMMMMMMMMMMMMMMMMMMMMMMMMMMMMMMMMMMMMMMMMMMMMMMM
M MMMMMMMMMMMMMMMMMMMMMMMMMMMMMMM MMMMMMM MMMMMMMMMMMMMMM
M MMMMMMMMMMMMMMMMMMMMMMMMMMMMMM MMMMMMM MMMMMMMMMMMMMMMM
M MMMMMM  MM MMMM M   MMM   MM    MMMM    MMMMMM  MMMMMMM
M MMMMM MM M  MMM M MM MM MM M MMMMMMM MMMMMMMM MM MMMMMM
M MMMMM    M MM M M MMM M   MM   MMMMM   MMMMM MMMM MMMMM
M MMMMM MM M MMM  M MM MM MM M MMMMMMM MMMMMMMM MM MMMMMM
M MMMMM MM M MMMM M   MMM MM M    MMMM    MMMMMM  MMMMMMM
M MMMMMMMMMMMMMMMMMMMMMMMMMMMMMMMMMMMMMMMMMMMMMMMMMMMMMMM
M                                                       M
MMMMMMMMMMMMMMMMMMMMMMMMMMMMMMMMMMMMMMMMMMMMMMMMMMMMMMM M
MMMMMMMMMM MMMMM M    M MMMM MM MMM  MMM   MMMMMMMMMMMM M
MMMMMMMMMM M M M M MMMM MMMM MM MM MM MM MM MMMMMMMMMMM M
MMMMMMMMMM MM MM M   MM MMMM    M MMMM M   MMMMMMMMMMMM M
MMMMMMMMMM MMMMM M MMMM MMMM MM MM MM MM MM MMMMMMMMMMM M
MMMMMMMMMM MMMMM M    M    M MM MMM  MMM MM MMMMMMMMMMM M
MMMMMMMMMMMMMMMMMMMMMMMMMMMMMMMMMMMMMMMMMMMMMMMMMMMMMMM M
M                                                       M
M MMMMMMMMMMMMMMMMMMMMMMMMMMMMMMMMMMMMMMMMMMMMMMMMMMMMMMM
M MM   MM   MMMM  MMM    M    MMM  MMM  MMMM  MMM   MMMMM
M MM MM M MM MM MM MM MMMM MMMMM MMMM MMMMM MM MM MM MMMM
M MM   MM   MM MMMM M   MM   MMMM  MMM  MM MMMM M   MMMMM
M MM MMMM MM MM MM MM MMMM MMMMMMMM MMMM MM MM MM MM MMMM
M MM MMMM MM MMM  MMM MMMM    MMM  MMM  MMMM  MMM MM MMMM
M MMMMMMMMMMMMMMMMMMMMMMMMMMMMMMMMMMMMMMMMMMMMMMMMMMMMMMM
M                                                       S
MMMMMMMMMMMMMMMMMMMMMMMMMMMMMMMMMMMMMMMMMMMMMMMMMMMMMMMMM