50 50
MMMMMMMMMMMMMMMMMMMMMMMMMMMMMMMMMMMMMMMMMMMMMMMMMM
E    M        MMMMMMMM      MMM      MMMMMMMMMMMMM
MMMM M MMMMMM MMMMMMMM MMMM  MM MMMM M     MMMMMMM
MMMM M MMMMMM MMMMMMMM MMMMM MM MMMM M MMM MMMMMMM
MMMM M MMMMMM MMMMMMMM M   M MM M  M M MMM  MMMMMM
MMMM M M    M MMMMMMMM M M M MM M MM M MMMM MMMMMM
M    M M MM M MM    MM M M M MM M MM M    M MM   M
MMMM M M MM M MM MM MM M M M MM M MM M MM M MM M M
MMMM   M MM M MM MM MM M M M MM M MM M MM M MM M M
MMMM MMM MM M MM MM MM M M M MM M MM M MM M MM M M
MMMM MMM MM M    MM MM M M M MM M MM M MM M MM M M
MMMMMMM  MM MMMMMMM MM M M M MM M MM M MM M MM M M
M       MMM MMMMMMM MM M M M MM M    M MM M MM M M
M MMMMM MMM MMMMMMM MM M M M MM MMMMMM MM M MM M M
M     M MMM MMMMMMM MM M M M MM MMMMMM MM M MM M M
M MMM M MMM         MM M M M MM   MMMM MM M MM M M
M M   M MMMMMMMMMMMMMM M M M MM M   MM MM M MM M M
M M M M MMMMMMMMMMMMMM M M M MM MMM MM MM M MM M M
M MMM M                M M   MM MMM MM MM M MM M M
M MMM MMMMMMM MMMMMMMMMM MMMMMM MMM MM MM M MM M M
M M           MMMMMMMMMM        MM  MM MM M MM M M
M MMMMMMMMMMMMM    MMMMMMMMMMMMMMM MMM MM M MM M M
M MM            MM             MMM MMM MM M MM M M
M MM MMMMMMMMMMMMMMMMMMMMMMMMM MMM  MM MM M  M M M
M MM MMMMMMMMMMM   MMMMMMMMMMM MMMM MM MM MM M M M
M MM MMM         M        MMMM  MMM MM MM MM M M M
M MM MMM MMMMMMMMMMMMMMMM MMMMM MMM    MM MM M M M
M MM MMM  MM            M MMMMM MMMMMMMMMMMM M M M
M MM MMMM MM MMMMMMMMMM M MMMMM           MM M M M
M MM MMMM MM MMMMMMMMMM M M    MMMMMMMMMM  M M M M
M MM MMM  MM MMMMMMMMMM M M MM MMMMMM    M M M M M
M MM MMM MMM MMMMMMMMMM M M MM MMMMMM MM M M M M M
M MM MMM MMM         MM M M MM      M MM M M   M M
M MM MMM MMMMMMMMMMM MM   M MM MMMM M MM M MMMMM M
M MM  MM MMMMMMMMMMM MMMMMMMMM MMMM M MM M MMMMM M
M MMM              M MMMMMMMMM M MM M MM M MMMMM M
M  MMMMMMMMMMMMMMM M  MM       M MM M MM M  MMMM M
MM               M MM    MMMMMMM MM M MM MM      M
MMMMMMMMMMMMMMMM M MMMMMMM     M MM M MMMMMMMMMMMM
M                M MM      MMM M MM           MMMM
M MMMMMMMMMMMMMMMM MM MMMMMMMMMM MMMMMMMMMMMM    M
M MMM              MM             MMMMMMMMMMM MM M
M MMM MMMMMMMMMMMMMMMMMMMMMMMMMMM     MMMMMMM MM M
M MMM MMMMMMM          MM    MMMMMMMM       M  M M
M MMM         MMM MMMM MM MM M       MMMMMM   MM M
M MMMMMMMMMMMM    MMM  MM MM M MMMMMMMMMMMM M  M M
M              MM MMM MMM MM M              MMMM M
MMMMMMMMMMMMMMMMM     MMM MM MMMMMMMMMMMMMMMMMMM M
MMMMMMMMMMMMMMMMMMMMM M   MM                     M
MMMMMMMMMMMMMMMMMMMMMMMSMMMMMMMMMMMMMMMMMMMMMMMMMM
