40 40
MMMMMMMMMMMMMMMMMMMMMMMMMMMMMMMMMMMMMMMM
E                                      M
M MMMMMMMMMMMMMMMMMMMMMMMMMMMMMMMMMMMM M
M M               MMMMMMMMMMMMMMMMMMMM M
M M MMMMMMMMMMMMM M                  M M
M M             M M M MMMMMMMMMMMMMM M M
M MMMMMMMMMMMMM M M M M              M M
M        MMMMMM M MMM MMMMMMMMMMMMMMMM M
M M MMMM M      M     M                M
M M M  M M MMMMMMMMMMMM MMMMMMMMMMMMMM M
M M M MM M M    M     M     M   M  MMM M
M M M MM M M MM M MMMMMMMMM M M MM   M M
M M M  M M   M  M     M   M M M MM M M M
M M MM M MMMMM MMMMMM M M M M M MM M M M
M M    M              M M M M M MM M MMM
M MMMMMM  MMMMMMMMMMMMM M M M M M  M  MM
M        MM             M M M M MMMMM MM
M MMMMM  M  MMMMMMMMMMMMM M M M M   M MM
M M   MMMM MM           M M M M M      M
M M M         MMMMMMMMMMM M M M MMMMMM M
M M MMMMMMMMMMMM          M M M M      M
M M            M MMMMMMMMMM M M M MMMM M
M M M MMMMMMMM M            M M M M  M M
M M M M  M     MMMMMMMMMMMMMM M M M MM M
M MMMMMM MMMM MM              M M M M  M
M M   MM MMMMMM  MMMMMMMMMMM MM M M M MM
M M M      M    MM         M M    M M MM
M M MMMMMM M MMMM  MMMMMMM M MM MMM M MM
M M     M  M M MM MM     M M MM M   M MM
M M MMM M MM M MM    MMM M M MM M MMM MM
M M M M M M  M MMMMMMM M M M MM M M M MM
M M M M M M MM MMM   M M M M MM M M M MM
M M M M M M M      MMM   M M MM M M M  M
M M M M M M M M MMMMMMMMMM M  M M M MM M
M M M M M M   M            MM M M M MM M
M M M M M MMMMMMMMMMMMMMMMMMM M M M MM M
M M   M M M                   M M M    M
M MMMMM M M MMMMMMMMMMMMMMMMMMM M M MM M
M       M   M                   M   MM S
MMMMMMMMMMMMMMMMMMMMMMMMMMMMMMMMMMMMMMMM
