50 59
MMMMMMMMMMMMMMMMMMMMMMMMMMMMMMMMMMMMMMMMMMMMMMMMMMMMMMMMMMM
MMMMMMMMMMMMMMMM      M                             MMMMMMM
MMMMMMMMMMMMMMMM MM M   MMMMMMMMMMMMMMMMMMMMMMMMMMM       M
MMMMMMMMMMMMMMMM MM MMM M     M                MMMMMMMMMM M
MMMMMMMMMMMMMMMM M   MM M MMM M MMMMMMMMMMMMMM       MMMM M
MMM        MMMMM M M MM M  M  M MMMMMMMMMMMMMMMMMMMM MMMM M
MM  MMMMMM  MMMM MMM  M MMMM M  MMMMMMMMMMMMMMMMMMMM MMMM M
MM MMMMMMMM MMMM  MMMMM      M MMMMMMMMMM         MM MMMM M
MM MMMMM    MMMMM   MMMMMMMMMM MMMMMMMMMM MMM MMM MM MMMM M
M  MMMM  MMMMMMMMMM          M MMMMMMMMMM MMM MMM MM MMMM M
M MMMM  MMMMMMMMMMMMMMMMMMMM   MMMMMMMMMM MMM MMM MM MMMM M
M MMMM                 MMMMMMMMMMMMMMMMMM MMM MMM MM MMMM M
M MMMMMMMMMMMMMMMMMMMM                    MMM  MM MM MMMM M
M  MMMMMMMMMMMMMMMMMMM MMMMMMMM MMMMMMMMMMMMMM MM MM MMMM M
MM MMMMMMMMMMMMMMMMMMM MMMMMMMM M     MMMMMMMM MM MM MMMM M
MM  MMMMMMMMMMM  MMMMM MMMMMMMM   MMM          MM MM MMMM M
MMM      MMM     MMMMM MMMMMMMMMMMMMMM MMMMMMMMMM MM MMMM M
MMMMMMMM     MMM MMMMM MMMMMMMMMMMM    MMMMMMMMMM MM MMMM M
MMMMMMMMMMMMMMM  MMMMM MMMMM     MMMMMMMMMMMMMM   MM MMMM M
M       MMMM MM MMMMMM MMMMM MMM                MMMM MMMM M
MMMM MM MMMM MM MMMMMM MMMMM MMMMMMMMMMMMMMMMMMMMMMM MMMM M
MMMM MM      MM MMMMMM MMMMM  MMM  MMMMMMMMMMMMMMMM  MMMM M
MMMM MMMMM MMMM  MMMMM MMMMMM MMM          MMMMMMMM MMMMM M
MMMM MMMMM MMMMM MMMMM MMMMMM MMM MMMMMMMM          MMMMM M
MMMM MMMMM MMMMM MMMMM MMMMMM MMM MMMMMMMMMMMMMMMMM MMM   M
E          MMM   MMMMM MMMMMM MMM MMMMMMMMMMMMMMMMM MM  MMM
MMMMM MMMM     MMMMMMM MMMMMM MMM MMMMMMMMMMMMMMMMM MM MMMM
MMMMM MMMMMMMMMMMMMM   MMMMMM MMM MMMMMMMMMMMMMMMMM MM MMMM
MMMMM MMM    MMMMMMMMMMMMMMMM MMM MMMM           M  MM M MM
MMMMM MMMMMM          MMMMMMM MMM MMMM MMMMMMMMM M MMM M MM
M     MMMMMMMMMMMMMMMMMMMMMMM MMM  MM  MMMMMMMM  M MM  M MM
MMMMMMMMMMMMMMMMMMMMMMMMMMMMM MMMM MM MMM   MMM MM MM MM MM
MMMMMM                        MMMM MM MMM MMMMM MM MM MM MM
MMMMMM MMMMMMMMMMMMMMMMMMMMMMMMMMM MM MM  MMMMM MM MM  M MM
MMMMMM MMMMMMMMMMM                 MM MM MMMMMM MM  MM M MM
MMMMMM MMMMMMMMMMM MMMMM MMMMMMMMMMMM MM MMMMMM MMM MM M  M
MMMMMM MMMMMMMMMMM MMMMM M    MMMMMMM MM MMMMMM MMM MM MM M
MM                   MMM   MM       M MM  MMMMM MMM MM MM M
MM MMMMMMMMMMMMMMM M MMM MM M MM MM M MMM MMMMM     MM  M M
MM MMMM        MMMMM  MM MM M MM MMMM MMM  MMMMMMMM MMM M M
MM MMMMMMMMMMM MMMMMM M MMM   MM MMMM MMMM       MM MMM M M
MM MM              MM M M M MMMM MMMM  MMMMMMMMM MMMMMM M M
MM MMMMMMMMMMM MMMMMM M M M MMMM MMMMM MMMMMMMMM        M M
MM MMMMMMMMMMM MMMMMM M     M       MM M      MMMMMMMM MM M
MM MMMMMMMMMMM MMMMMM MMMMMMMMMMMMMMM  MMMMMM             M
MM MMMMMMMMMMM MMMMMM                 MMMMMMM MMMMMMMMMMMMM
MM MMMMMMMMMMM MMMMMMMMMMMMMMMMMMMMMMMMMMMMMM MMMMMMMMMMMMM
MM   MMMMMMMMM MMMMMMMMMMMMMMMMMMMMM   MMMM               S
MMMM                MMMMMMMMMMMMMMMMMM      MMMMMMMMMMMMMMM
MMMMMMMMMMMMMMMMMMMMMMMMMMMMMMMMMMMMMMMMMMMMMMMMMMMMMMMMMMM
