20 30
MMMMMMMMMMMMMMMMMMMMMMMMMMMMMM
E       MMM       MMM       MM
MMM MMMMMMMMM MMMMMMMMM MMMMMM
M        MM                  M
MMM MMMMMMMMM MMMMMMMMM MMMMMM
MMM      MMMM      MMMM      M
MM   M  MMMM   M  MMMM   M  MM
MM MMMMMMMMM MMMMMMMMM MMMMMMM
MM MM M MMMM MM M MMMM MM M MM
M        MM        MM        M
M       MMM       MMM       MM
MMM MMMMMMMMM MMMMMMMMM MMMMMM
M        MM        MM        M
MMM MMMMMMMMM MMMMMMMMM MMMMMM
MMM      MMMM      MMMM      M
MM   M  MMMM   M  MMMM   M  MM
MM MMMMMMMMM MMMMMMMMM MMMMMMM
MM MM M MMMM MM M MMMM MM M MM
M                  MM        S
MMMMMMMMMMMMMMMMMMMMMMMMMMMMMM
