11 10
MMMMMMMMMM
M       MM
MMM MMMMMM
E        M
MMM MMMMMM
MMM      M
MM   M  MM
MM MMMMMMM
MM MM M MM
M        S
MMMMMMMMMM
