18 17
MMMMMMMMMMMMMMMMM
E               M
MMM MMMMMMMMMMMMM
MMM MMM         M
MMM MMM MMMMMMMMM
MMM             M
MMMMMM MMMMMMMM M
MMMMMM MMMMMMMM M
M      M        M
M MMMM MMM MMMM M
M MMMM MMM MMMM M
M M    MMM    M M
M M MMMMMMMMMMM M
M M           M M
M MMMMMM M MM M M
M      M MMMMMMMM
MMMMMMMM        S
MMMMMMMMMMMMMMMMM